50 10
.................................#################
################.................#################
################....#########....#################
################....#########....#################
################....#########....#################
################....#########....#################
################....#########....#################
################....#########....#################
################.................#################
################..................................
