30 30
.##.#.##.###.######...##.####.
..#....###....###.#..#...##...
......###..##.#...##.#.###..#.
####...####.#...#.#.###..##.#.
.....##..####..###..###.#.#..#
.###.#..#.##..#.#.##..#.....#.
###.#..#.#.#..#....#.########.
#..#####.#...#.##.####...#...#
....###...#..###..##.##.##.##.
#..#.#..#.....#.##.##...######
#.#.##########.###...#..##.#.#
..##...##...#.##########..#.##
###..#.######.#...##...#..##.#
.#..####...#.###.#.#...##.#.#.
###.####.###.#.##.##.##......#
...#...###......###..#.##.##.#
..#..#...##..#....##.#...###.#
......##......##.###.#....####
..#....######...#.....#.###...
.#.##.#...##..#.......#.#.#...
..##..##.#.##.#...#..####.##..
#...#..#.#...#.....#...#..####
#....#....##........##.......#
#######.##.#.######.######.##.
.###.#.#####.#.#.....####..##.
###..##.#.#...#.#.....###.#.#.
..####..###.##.##.#..#.#...#.#
#...#####.#...#####.####.##..#
.##.#.#....####..####..#...###
##..#.#..#.#.#.#...##..##.###.
