100 100
..#...#..###.#.##.####...###..#..#.##.###...#.#.#.#.##....##..#.#.#....#..#####.#..##.#...#...#.....
#..####.....#.#....#.##.....###.###....##.#....#.#...#...###..###..##...##.##..##.#.....#####......#
#.#..###..##..#....###.####.###..#....#.....##########...#..#..######..##.#.#.##...#..#.#....###...#
#....#...##..##.#....##...#.#.#..#.#..#.#..####.....####..##..####.###..#....#..#....##...#...#####.
.#.##.##.###....##.#.#..##..##.#..###.##..........#.##..#...#.##..###..#.########.#....#..#...#.#...
..###..###..#..#.....#.....#..###.....###.#..#..#..#.##.####...#..#..####..##.#..##....#######.#..#.
#.....##..#.#.#..##.#.#......#.#..#......###..#.##..#.##.##...#...##.##...#..##..#.#####..##..##....
##......##.###...#.#.#...##..########.#.#.#.#.####.#.....##.#.#.#####.#..####.#.##.#....##..##...###
.#...#.####..##.##.#..##....##.#....#.#.##.#.#..#.###.##.##..######.##.........#.#.#.#.....##..#####
..#..##.###.#.###.#...##.#.#...#..#.#.##..##.....#..##.#..#..##.#####..#.#.##.#..#.#..#.#..##..###..
#..##...##.#.#..##..##.##...#.....###.#.#.#.##..###..######.##.#.#.##.##..#####...#.#.#....#..#..###
#..#.#.##..#.#..##.#.##.#..#######.###..#.#######..####.##.#.#.#...##.#.##...####...####.#....#..#..
.#.#..##.#.###...###.##.##........#.####...##.####.#..#.#..#.....###.....#######.#..#.........###...
.#.#...###.####.#.##.####......###.##.#..###..##...##.....##.#....##..#...#.##.##..#..##...#..#.....
####..####.#.#..###..##.#..#...#.#..#.####.#....##.####.#..#..#.##..######.##.##.#.#..##.##.#.#.####
#.....####.#.#.###.####.#.##...#..#....##...#.#..######.#.##.#.####..###..##.....###.##.###...#.#..#
.##.#.#.##.##..####..#.####..#...#..##..#.#..#####.#...#.##..#.#..#.##..#...#.#.##.#.....#..#.##..##
#..#..##...#..........##....#.#..##...#.##.##.#.##.###.#..##..#..#..#...#.###.#.###.#####...##.#.##.
##....##..#....##......###...#.##.##.#.#######..#....##.....#.#...####.#.#.#.##.#...##.##.##..#..##.
.###.#.#..#..#.#.....##.#..##.#.#.#..##.#..##..#..#.#...##..##...#..##..##..#...##...###.###..#.#...
####.######.#.###..###.###.##.###..######.#...##.#.#..#..####..##....###.##.#...#.###.###..###..#..#
....##..#...#....##..###.##.#####.#.#.##.######.#..#.#...#.#..#....#.#.##...#.....#.####.####.##.###
##..#..#.#######...#.#.####...#######...###...###..##..######.###......###...#####.##....####...#..#
.##..#...##..###.##...###.#..###..#####..#...##.......##..#.###.#.###.#####......#.###.##.#.##..####
...##.##..####....##...##..#.#....##.####........#.##..#..........###...#..#..#.###.#.#..#..##..#.#.
.#.##..#..##########.#.....#.###.#.###.###....###.##.##.##...##.###..#.##..#.###..#.#........####.##
.###.#...#..##..######.###..#.###..###......##...#.##.#.##..##.#...##.#....##..#...#.######..##....#
.#####....#...#.#.#.####.......###.##.#######....###...#..##.#..#.#...###.#..##...##.#...##.##..##..
.####..####.#.######.#.#..#..#...###.#.#.####..##...#.######.####..#.#........#..#.#.###...#.#.##..#
#......#.###.#...###.#....#..##.##..#.#.#.####.###.##.##..#####..#..##..###..#.##...######...##..#.#
#.#.###..####.#.##.#..#......#.#####..###..#..#.####..#.##.#.....##...##...#..###..#.###...#..#...#.
..#...#...##.###...#.#.######.########.###..####.#....#.###.###..#.#...##.#.........#...#.#.#.####.#
#.#...#.##.####.#.#....#.#....##....###..###...#.##.#.#####.######...#...#.#....#.#...##.###.###.#.#
..#..##.#....#....#.####....#.####.#.##.##.########...#.##.....##..#####...##...##.#.###.##.###.##.#
.#.##....#.#....###.##....#.###..##.##...####.#####..##.#..#####..#.#...###.#.###.##...#...#.##.#..#
..##...#.#....#..###....##.#.#..##.##.#########..##.##..####.###.####.###..##.#.#...##....#.###...#.
..#.###.#....#.#.#..##...#.#..#....###.##.###.#####..#.###.######.#.######.###.....##...#.#.##..##..
..###...##..#.#..##.#...#...#.##..##.##..#.###...#.##.#####.#...####.###.#......#.##...###.#..###..#
#...##..#..#........#.##...#.#..##.....#.#..#..#..#...#...###.#.##.###.#.#####.......####....#.#.#.#
.#...###.##.###.#.#..###.#...##..#...##.###....#.#...##....#####..#.#.#.#.#..##.##.#...#...#.#..####
#.##..#....#......#.#######...#..##.#..#....#####....##########....#.######.....#..##...##...#...#..
.###.#.##.#..#####..#.####.#....##.#.....#..#.#.###.#..##......#.....#...#.##...######..#..###.##.#.
#...###.##...###.#.#...##..####.##.....###...#####.#.#.##...#########.######...#.#....##....###.....
.###..#..#......#..#..###..##.###.##..#####....#......##.####.#.#.##.#.#..#...#....#.#..##...####..#
##..#..#..#..##....##..###..####..##.#..##.#..#....#..#.##....#...#..#.#..#...#..#.####..#.##.##.##.
.#.#.##.#.#.###.....######.#....#.####..##.#.##.#..##...#.##.##.###..###.#..#....######...#....##..#
###..#.###.#.#.#####..#...#..###..##...##.##.#.###.######.##.##.#.##..##....#.#.###.#...##.#.##.###.
#.##.....#..#......#....#..##.#...##.######.##....#.#....####.###..#.#.####.##.##.#..##...###.#..##.
#.#.#...#####.##..#.#....#...####.###.#.###.#####.......#..#.###...#..#####....#.......###.#.#...##.
##...#....#..##..###...##.####......##.###..##.#...#...#.##..#..##.....#..###..#......#.....###..##.
.##.###.#####.##..#.#.#.#.###.###.#.#...###.#.#.##..##..#####..............#..###.#.#..###.##.##..##
..#..#..##..##.##..##....#.###..##.#.......###.##..#..####.##.#.##.#..#...###.....##.#....##...##..#
..#..####.##.#.#..#.......##..#.....###.#...#.###..#.....##.#..##.#.#.#####.#...........##.#...#..##
...###.##.##.##.##.##..#.....###...##..#....#..##.....#..#.##..#...###.###..#.#.#####.....##.#..#...
#...#.#...##..##.##.#.#.##.#..####..###.#.##..#.#.###.#..##..###.##......##...###....#..#..##..####.
.#..####...#.##..#####..#..#.##.##...##.####...#.#.#.#..#.###.#.#..###.###.#....###..#.######.#...#.
###.##.#..###.##.###...#..##.###...##..#.##...#...#....#.#...#####..##...#..##.#......#.##...#####..
...##.#............##.#.#.#..##.###..##.##.##.##.#..#....##.#.#.#.###.#.###...#.##..#.#....#.###..##
...#.##....#.#.######..##..#.###.#..........#..###..######.###.#.#########.##...#..###..#.....#.#.#.
##....#..#.#.#.#...##.##..#..#.#.....#..##.#....#....###..#.##.#....#.#.#####......###.#.#.#..#..###
#..###..#.#..##.####.#..####..#..###.##......#.#....#..#.#..##.#.#.##.##.##...#..#.#.....#.#.###.#.#
##..........#.##..#.#..###.#..#.##.##.##.##.###.##..#.#.#.#.......##.###..#.#...#...#..............#
##.#########..##..#......#####....####....#..##.##.##.###...#..#..####.###.#.###.#.#..##.#....#....#
..#####...##.....##.##.#..#..#..##.#.##.#.##..#.###..##.###..#....#.#..#...#..###..#.#.#.###..#.....
..#..##.##..#..##.#.#.##..##.##.#...#..##.#..#..##..###.#.###.##.#####....#.##.#..#####.#.##.....#.#
.....##..##...####.###......#.####.#.##.....#...#.#.##.####.##.....#####...#..##.###..#.#...#.#..###
..#..##.####.#..##...#.####...###.####...##....#####..###.#.###.#.###########.#.#..#.#..#...##..#.##
##.....#.#####.........###..###...#..##..###.######.###..####..#.#...#...###.#...#...#.###....#.####
######.#..#.##..###..#...####.#.#.#.#..#.#..#...##......##..##.##.##.#..#...#...#....#.#....#.##....
..#####..#.#####........####.#..###.....##...##.##...#.#.#.....###..#...#..#.####.####.#....#......#
.#..#.##.####.....#..###.#..#.######.#...###.##.#..#.##..#.######..##.##....##....#.....#..###..#.##
.....#.#..#.##.##.##.#........#..###.#.#..###....############....##..##.###.#####....######.##.#.#..
###...##..##.##.#...##.#.#.....#.#...#..####...#..#.#.######.##.##.#..###.....#..#.###..#####.#.####
...#.##.##...###..###...##..##.##..##.###.###..#.##.##..###..##.######..###.###........####.....####
.###.###.#######.#.##########..#####..###..#.#...###.##...#####....#.#..#.######.###..#....###.##..#
#.#....#.##...#...#..#.#..##.#.#..#..#..#####..#####.##.#.####.##...#...##....###..#.####.####.##.##
.########...#.##...#.#..###.#.#.###..##.##....#...###.#.#.#....##...##..#.##..##.....#.###.#...#..##
.#.#.#..###.##....##.#...##.##.#....#.#.#..#..#.#..#..#.#..##....#.###.#....##..#.###.#...#....##...
..#.##......###.##.##.##.#.#.##.##.....#..###.#.#....#..#.###.#####.#.##..#............###...###.###
#..#.###..#..##..#######.#....##...##..#.#...##...##.#...##.#.##.#..#.####...#.##..###.#.####...##.#
##.##.####.###....#.#.##.##..##..###..####.#.##.##.###..##.#.##......#....###.###..##.#.##.#.##..##.
.#.###.#.#.##..#.###.#..#####.###...#.##.#####.##..##....#####..##..#..#####.#.#########.#.#.###.###
####...##..###.#.#...##...#..###...#....#.#..##...###.######....#######...#.#....###...###.#...###.#
#.##..#.##.#######.##..#......##...####..###...#...#.#.##.##...#...####..##.#.##...##....#.##..##.#.
#..##.##.....#####....##.####.....#...#..###.........#.#.#.##.###.##.....##.#..#...##..##...###.####
##.#.#..#.#.###.##..#......##.#.##.......#.###....##.#..#....##..#..#..##.#.#####.####.##.#.#..##.#.
...#.#...####...#.##.#####.##.##.#......#.#...#...###..###..########...#.#..##..######.....###..#..#
....#..#####....#....###...#.....#.##..###..#..#..#.#.#..##.#..##.#.###.##..#.###.#.##.#......###.#.
.#.#.##.###.###..#..#..#...#..#.#.#####..###....#..#.#..##.###..###..##........#....##.....#..###...
##.##.##.#...#.#.#..#.##..##.##...##.#.#..#.#..##.#......###.##.#.####..#..#...#..#..#.#....##..####
..#..##..##.#.#..##.###..#.##..#.##.#..#.####.##...###.#..##.##.#...#.###..##..#....#.#.#.##...##.#.
#.#..####....#..##...#....##..##....##.##.#.##.#..#.##.###..######.##....#....#...#..####.#.##.#...#
....#..#####..#..######..##.##.##.....##.##.#..###....#.#.##.#.##..#####..#..##....#.###....###.##..
#####.#####.#.###..####..###.#.#.###...##.#...###.#.#..###....#...#.#.#..##.#.#....###...#.##.##.###
##.#.####...#.#.#...###.#..####..##....##.#..#..#...##..#..#.##..##.###.##.#..#####..##..##.....##.#
.###..#...##.....#...#.....#....#....#..#..#....#..#..#.#####.#..#...#..#.##.#.#....##...####..#..#.
#......##..#.###.####...#..####.#.#..#######..##...##.#.###.#....#...#.######..#...##.#.#...#.##.#..
#...###.#..#..##..#.##...##.##..#...###.##..###.##.........#########..#.##.#.##..#.######...###..###
####.#.#.###.#.#.#####..####....###..###....#.#.#.##.####..####....###.##.##.####..#...#.#.#......#.
.#####.#.###.##.###..##.###......###..#.#..#####..##..##..#.##.###.###.##..##..#.#..#..#.#####..###.
